MMMMMMMMMMMMMMMMMMMMMMMMMMMMMMMM 
MXXXXXXXXXXXXXXMXXXXXXXXXXXDXXXM  
M MMMMMMXMMMMMMMMMMMMMXMMMMMMMXM 
MXMMMMMMXMMXXXXMXXXXMMXMMMMMMMXM 
MXXXXXXDXXXXMXXXXXMXXXXXXXXXXXXM 
MXMMMMMMMMMMMXMMMXMMMMMMMMMMMMXM 
MXXXXXXXXXXXMXXXXXMXXXXXXXXXXXXM 
MXMXMXMMMXMXXXM MXXXXMXMMMXMXMXM 
MXMXMXXXFXMXXMM MMXXXMXXXXXMXMXM 
MXMXMMMMMMMXXM   MXXXMMMMMMMXMXM 
MXMXXXXMXXXXXM   MXXXXXXMXXXXMXM
MXMXMMMMMMMXXMMMMMXXXMMMMMMMXMXM 
MXXXXXXMXXXXXXXXXXXXXXFXMXXXXXXM 
MXMMMMMMXMMMXXXMMXXXMMMXMMMMMMXM 
MXXXXXXXXXXMXMMMMMMXMXXXXXXXXXXM 
MXMMMMMMXMXMXXMXXMXXMXMXMMMMMMXM 
MXXXXXXMXMXXXXXXXXXXXXMXMXXXXXXM 
MXMMMMXMXMXMMMMMMMMMMXMXMXMMMMXM 
MXXXXXXXXMXXXMXXXXMXXXMXXXXDXXXM 
MXMMMMMMMMMMXMXMMXMXMMMMMMMMMMXM 
MXXXDXXXXXXXXXXXXXXXXXXXXXXXXXXM 
MMMMMMMMMMMMMMMMMMMMMMMMMMMMMMMM 