                                
                                
MMMMMMMMMMMMMMMMMMMMMMMMMMMMMMMM 
MXXXXXXXXXXXXXXMXXXXXXXXXXXDXXXM  
M MMMMMMXMMMMMMMMMMMMMXMMMMMMMXM 
MXMMMMMMXMMXXXXMXXXXMMXMMMMMMMXM 
MXXXXXXDXXXXMXXXXXMXXXXXXXXXXXXM 
MXMMMMMMMMMMMXMMMXMMMMMMMMMMMMXM 
MXXXXXXXXXXXMXXXXXMXXXXXXXXXXXXM 
MXMXMXMMMXMXXXM MXXXXMXMMMXMXMXM 
MXMXMXXXFXMXXMM MMXXXMXXXXXMXMXM 
 XMXMMMMMMMXXM   MXXXMMMMMMMXMX 
 XMXXXXMXXXXXM   MXXXXXXMXXXXMX
MXMXMMMMMMMXXMXXXMXXXMMMMMMMXMXM 
MXXXXXXMXXXXXMMXMMXXXXFXMXXXXXXM 
MXMMMMMMXMMMXXMXMXXXXXXXMMMMMMXM 
MXXXXXXXXXXMXXXXXXXXMXXXXXXXXXXM 
MXMMMMMMXMXMXXMMMXXXMXMXMMMMMMXM 
MXXXXXXMXMXXXXXXXXXXXXMXMXXXXXXM 
MXMMMMXMXMXMMMMMMMMMMXMXMXMMMMXM 
MXXXXXXXXMXXXMXXXXMXXXMXXXXDXXXM 
MXMMMMMMMMMMXMXMMXMXMMMMMMMMMMXM 
MXXXDXXXXXXXXXXXXXXXXXXXXXXXXXXM 
MMMMMMMMMMMMMMMMMMMMMMMMMMMMMMMM 