MMMMMMMMMMMMMMMMMMMMMMMMMMMMMMMM 
M------------------------------M  
M-MMMM-M-M-M-MMMMMMMM-MMMMM-MM-M 
M----M-MMM-M-M--------MM-------M 
M-MMMM---------MMMMM-----MMMMM-M 
M----MMMMMMM-M-M-----MMM-M-----M 
M-MMMMM------M-M-MMM-----MM-MM-M 
M-------MMMMMM-M-M---MMMMM-----M 
M-MMM-M-MM---------M-M-----MMM-M 
M-M---M----M-MM MM-M---M-M---M-M 
M-M-MMM-MMMM-M   M-MMM-M-MMM-M-M
M-------M----M   M---------M-M-M 
M-MMMMM---MM-M   M-MMM-MMM-M---M 
M-----M-M-MM-MMMMM-M-------MMM-M 
M-MMM---M----------M-MMMMM---M-M 
M-M---MMMMMMMMMMMM---------M---M 
M-MMM----MMMM------M-M-MMM---MMM 
M---M-MM------MMMMMM-M-----M---M 
M-M-M--MMMM-M--------MMMMMMMMM-M 
M-M-MM------MMM-MMMM---------M-M 
M------MMMM----------MMMMMMM---M 
MMMMMMMMMMMMMMMMMMMMMMMMMMMMMMMM 