MMMMMMMMMMMMMMMMMMMMMMMMMMMMMMMM 
MXXXXXXXXXXXXXXMXXXXXXXXXXXXXXXM  
M MMMMMMXMMMMMMMMMMMMMXMMMMMMMXM 
MXMMMMMMXMMXXXXMXXXXMMXMMMMMMMXM 
MXXXXXXXXXXXMXXXXXMXXXXXXXXXXXXM 
MXMMMMMMMMMMMXMMMXMMMMMMMMMMMMXM 
MXXXXXXXXXXXMXXXXXMXXXXXXXXXXXXM 
MXMXMXMMMXMXXXM MXXXXMXMMMXMXMXM 
MXMXMXXXXXMXXMM MMXXXMXXXXXMXMXM 
MXMXMMMMMMMXXM   MXXXMMMMMMMXMXM 
MXMXXXXMXXXXXM   MXXXXXXMXXXXMXM
MXMXMMMMMMMXXMMMMMXXXMMMMMMMXMXM 
MXXXXXXMXXXXXXXXXXXXXXXXMXXXXXXM 
MXMMMMMMXMMMXXXMMXXXMMMXMMMMMMXM 
MXXXXXXXXXXMXMMMMMMXMXXXXXXXXXXM 
MXMMMMMMXMXMXXMXXMXXMXMXMMMMMMXM 
MXXXXXXMXMXXXXXXXXXXXXMXMXXXXXXM 
MXMMMMXMXMXMMMMMMMMMMXMXMXMMMMXM 
MXXXXXXXXMXXXMXXXXMXXXMXXXXXXXXM 
MXMMMMMMMMMMXMXMMXMXMMMMMMMMMMXM 
MXXXXXXXXXXXXXXXXXXXXXXXXXXXXXXM 
MMMMMMMMMMMMMMMMMMMMMMMMMMMMMMMM 