

MMMMMMMMMMMMMMMMMMMMMMMMMMMMMMMM 
MXXXXXXXXDXMXXXXXXXXXXXXXXXXXXXM  
M MMMMXMXMXMXMMMMMMMMXMMXMMXMMXM 
MXXXXMXMMMXMXMXXXXXXXFMMXXXXXXXM 
MXMMMMXXXXXXXXXMMMMMXXXXXMMMMMDM 
MXXXXMMXMMMMXMXMXXXXXMMMXMXXXXXM 
MXMMMMMXXXXXXMXMXMMMXXXXXMMXMMXM 
MXXXXXXXMMXMMMXMXMXMXMMMXXXXXXXM 
MXMMMXMXMMXXXXXXXXXXXXXXXMXMMMXM 
MXMXXXMXFXXMXMM MMMMMMXMXMXXXMXM 
 XMXMMMXMMMMXM   MMMMMXMXMXMXMX
 XXXXXXXMXXXXM   MXXXXXXXXXXXMX 
MXMMMMMXXXMMXM   MXMXMXMMMMMXXXM 
MXXXXXMXMXMMXMM MMXMXXXXXXXMMMXM 
MXMMMXXXXXXXXXXXXXXXXMMMMMXXXMXM 
MXMXXXMMMMMMMMMMMMMMXXXXFXXMXXXM 
MXMMMXXXXMMMMXXXXXXMXMXMMMXXXMMM 
MXXXMXMMXXXXXXMMMMMMXMXXXXXMXXXM 
MXMXMDXMMMMXMXXXXXXXXMMMMMMMMMXM 
MXMXMMXXXXXXMMMXMMMMXXXXXXXDXMXM 
MXXXXXXMMMMXXXXXXXXXXMMMMMMMXXXM 
MMMMMMMMMMMMMMMMMMMMMMMMMMMMMMMM 