MMMMMMMMMMMMMMMMMMMMMMMMMMMMMMMM 
MXXXXXXXXDXXXXXXXXXXXXXXXXXXXXXM  
M MMMMXMXMXMXMMMMMMMMXMMMMMXMMXM 
MXXXXMXMMMXMXMXXXXXXXFMMXXXXXXXM 
MXMMMMXXXXXXXXXMMMMMXXXXXMMMMMDM 
MXXXXMMMMMMMXMXMXXXXXMMMXMXXXXXM 
MXMMMMMXXXXXXMXMXMMMXXXXXMMXMMXM 
MXXXXXXXMMMMMMXMXMXXXMMMMMXXXXXM 
MXMMMXMXMMXXXXXXXXXMXMXXXXXMMMXM 
MXMXXXMXFXXMXMM MMXMXXXMXMXXXMXM 
MXMXMMMXMMMMXM   MXMMMXMXMMMXMXM
MXXXXXXXMXXXXM   MXXXXXXXXXMXMXM 
MXMMMMMXXXMMXM   MXMMMXMMMXMXXXM 
MXXXXXMXMXMMXMMMMMXMXXXXXXXMMMXM 
MXMMMXXXMXXXXXXXXXXMXMMMMMXXXMXM 
MXMXXXMMMMMMMMMMMMXXXXXXFXXMXXXM 
MXMMMXXXXMMMMXXXXXXMXMXMMMXXXMMM 
MXXXMXMMXXXXXXMMMMMMXMXXXXXMXXXM 
MXMXMDXMMMMXMXXXXXXXXMMMMMMMMMXM 
MXMXMMXXXXXXMMMXMMMMXXXXXXXDXMXM 
MXXXXXXMMMMXXXXXXXXXXMMMMMMMXXXM 
MMMMMMMMMMMMMMMMMMMMMMMMMMMMMMMM 