 
 
MMMMMMMMMMMMMMMMMMMMMMMMMMMMMMMM 
MXXXXXMMDXXXXMMMMMMMMMMMMMMMMMMM 
M MMMXXMMXMXMMMMMMMMMMXXXXXXXXXM 
MXMMMMXXXXMXXXXXXXXXXXXMMMMMMMXM 
MXMXXXMMMXMMMMXMMMMMXMMMMXXXXXDM 
MXXXMXXXXXXFXXXMMMMMXMMMMXMMMMMM 
MMMMMXMMMXMMMMXMMMMMXMMMMXMMMMMM 
MXXXXXMMMXMMMMXMMMMMXMMMMXMMMMMM 
MXMMMXMMMXMMMMXXXXXXXXXMMXXXXXXM 
 XMMMXMMMXMMMMM MMXMMMXXXXMMMMX  
 XXMMXMMMXMMMM   MXMMMMMMXMMMMX  
MMXMMXMMMXXXXM   MXMMMMMMXMMMMXM 
MMXMMXMMMXMMXM   MXXXXXXXXMMMMXM 
MMXXXXXXXXXXXMMMMMXMMMMMMXXXXXXM 
MMXMMMMMXMMMXXXXXXXXXXMMMMXMMMXM 
MMXMMMMMXMMMMMMMMXMMMXMMMMXMMMXM 
MMXMMMMMXMMXXXXXXXMMMXMMMXXXMMXM 
MMXXXXXXXXXXMMMMMXMMMXMMMXMXMMXM 
MMMXMMMMXMMMMMMMMXXXXXXXXXMXMMXM 
MMMXMMMMXMMMMMMMMXMMMMMMXMMXMMXM 
MDXXXXXXXXXXXXXXXXXXXXXXXMMXXXDM 
MMMMMMMMMMMMMMMMMMMMMMMMMMMMMMMM 