 
 
MMMMMMMMMMMMMMMMMMMMMMMMMMMMMMMM 
MXXXXXMMXXXXXMMMMMMMMMMMMMMMMMMM 
M MMMXXMMXMXMMMMMMMMMMXXXXXXXXXM 
MXXXMMXXXXMXXXXXXXXXXXXMMMMMMMXM 
MXMXXXMMMXMMMMXXXMMMXMMMMXXXXXDM 
MXXXMXXXXXXFXMXMMMMMXMMMMXMMMMMM 
MMMMMXMMMXMMMMXMMMMMXMMMMXMMMMMM 
MXXXXXXM   MMMXMMMMMXMMMMXMMMMMM 
MXMMMXMM   MMMXXXXXXXXXMMXXXXXXM 
MXDMMXXM   MMMXMMMXMMMXXXXMMMMXM 
MMMMMMMMMMMMMMX     M     MMMMXM 
MMMMMMMM                  MMMMXM 
MMMMMMMM                  MMMMXM 
MMXXXXXX                 XXXXXXM 
MMXMMMMM                       M 
MMXMMMMM                       M 
MMXMMMMM                       M 
MMXXXXXX                       M 
MMMMMMMM                       M 
MMMMMMMM                       M 
MDXXXXXX                       M 
MMMMMMMMMMMMMMMMMMMMMMMMMMMMMMMM 