 
 
MMMMMMMMMMMMMMMMMMMMMMMMMMMMMMMM 
MXXXXXMMXXXXXM                 M 
M MMMXXMMXMXMM                 M 
MXXXMMXXXXMXXX                 M 
MMMXXXMMMXMMMM                 M 
MDXXMXXXXXXFXM                 M 
MMMMMMMMMXMMMM                 M 
M      M   M                   M 
M      M   M                   M 
M      M   M                   M 
M      MMMMM                   M 
M                              M 
M                              M 
M                              M 
M                              M 
M                              M 
M                              M 
M                              M 
M                              M 
M                              M 
M                              M 
MMMMMMMMMMMMMMMMMMMMMMMMMMMMMMMM 